0000000000000000
0000000000000000
0000000000000000
0000000000000000
7700000000000000
3600070070000000
a600030030770000
aa000a00a7337000
aa000a0733333777
aa777a7333333333
3333333333333333
3333333333333333
